******************
*@...............*
*................*
*................*
*................*
*................*
*................*
*.............*..*
*.............*..*
*.............*..*
*..........****..*
*................*
*...............?*
******************
