***************
*.@...........*
*.............*
*..........*..*
*.......****..*
*............?*
***************
