********..*****
*.............*
*...****...*..*
*...*.@....*..*
*...********..*
*............?*
***************
