********
@.&...**
*.*....*
*.**.*?*
********
